12.oT
..o...............o
..............o....
.o....o....o.....o.
.........o....o....
....o.......o......
........o.....o....
.......o...o.......
.............o.....
....o.......o......
....o....o.....o...
....o..............
....o....o...o.....
